L0: ;H: Hole B: Block P: Plushable 0: Free M: Man
0 0 0 0 0 0 0 0 0 0 0 0 0 0 0 0 0 0
0 0 0 0 0 0 0 P 0 0 0 0 0 0 H 0 0 0
0 0 0 B 0 0 0 0 0 0 H 0 0 0 0 0 0 0
0 0 0 0 B 0 0 0 0 0 0 0 M 0 0 0 0 0
0 0 0 0 0 B 0 0 P 0 0 0 0 0 0 0 0 0
0 0 H 0 0 0 0 0 0 0 0 0 0 0 0 0 0 0
0 0 0 0 0 0 0 0 0 0 0 0 0 0 0 0 0 0
0 0 0 0 0 B 0 0 P 0 0 0 0 0 0 0 0 0
0 0 H 0 0 0 0 0 0 0 0 0 0 0 0 0 0 0
0 0 0 0 0 0 0 0 0 0 0 0 0 0 0 0 0 0
0 0 0 0 0 B 0 0 P 0 0 0 0 0 0 0 0 0
0 0 H 0 0 0 0 0 0 0 0 0 0 0 0 0 0 0
0 0 0 0 0 0 0 0 0 0 0 0 0 0 0 0 0 0
L1: ;H: Hole B: Block P: Plushable 0: Free M: Man
0 0 0 0 0 0 0 0 0 0 0 0 0 0 0 0 0 0
0 0 0 0 0 0 0 P 0 0 0 0 0 0 H 0 0 0
0 0 0 B 0 0 0 0 0 0 H 0 0 0 0 0 0 0
0 0 0 0 B 0 0 0 0 0 0 0 M 0 0 0 0 0
0 0 0 0 0 B 0 0 P 0 0 0 0 0 0 0 0 0
0 0 H 0 0 0 0 0 0 0 0 0 0 0 0 0 0 0
0 0 0 0 0 0 0 0 0 0 0 0 0 0 0 0 0 0
0 0 0 0 0 B 0 0 P 0 0 0 0 0 0 0 0 0
0 0 H 0 0 0 0 0 0 0 0 0 0 0 0 0 0 0
0 0 0 0 0 0 0 0 0 0 0 0 0 0 0 0 0 0
0 0 0 0 0 B 0 0 P 0 0 0 0 0 0 0 0 0
0 0 H 0 0 0 0 0 0 0 0 0 0 0 0 0 0 0
0 0 0 0 0 0 0 0 0 0 0 0 0 0 0 0 0 0


